t l l m e
m m l m l
l l l m l
l m m m l
l l l l p